0 0 0 0 0 0 0 0 0 0
0 0 1 1 1 1 1 0 0 0 
0 0 1 1 1 1 1 0 0 0
0 0 1 1 P 1 1 0 0 0
0 0 1 1 1 1 1 0 0 0
0 0 1 1 1 1 1 0 0 0 
0 0 1 1 1 1 0 0 0 0
0 0 0 1 B 1 0 0 0 0 
0 0 0 1 1 1 0 0 0 0
0 0 D 1 1 1 0 0 0 0



